109 109 109 109 109 109 109 109 109 109 109 109 109 109 109 109 109 109 109 109 109 109 109 109 109 109 109 109 109 109 109 109 109 109 109 109 109 109 109 109 109 109 109 109 109 109 109 109 109 109 
109 109 109 109 109 109 109 109 109 109 109 109 109 109 109 109 109 109 109 109 109 109 109 109 109 109 109 109 109 109 109 109 109 109 109 109 109 109 109 109 109 109 109 109 109 109 109 109 109 109 
109 109 109 109 109 109 109 109 109 109 109 109 109 109 109 109 109 109 109 109 109 109 109 109 109 109 109 109 109 109 109 109 109 109 109 109 109 109 109 109 109 109 109 109 109 109 109 109 109 109 
109 109 109 109 109 109 109 109 109 109 109 109 109 109 109 109 109 109 109 109 109 109 109 109 109 109 109 109 109 109 109 109 109 109 109 109 109 109 109 109 109 109 109 109 109 109 109 109 109 109 
109 109 109 109 109 109 109 109 109 109 109 109 109 109 109 109 109 109 109 109 109 109 109 109 109 109 109 109 109 109 109 109 109 109 109 109 109 109 109 109 109 109 109 109 109 109 109 109 109 109 
109 109 109 109 109 109 109 109 109 109 109 109 109 109 109 109 109 109 109 109 109 109 109 109 109 109 109 109 109 109 109 109 109 109 109 109 109 109 109 109 109 109 109 109 109 109 109 109 109 109 
109 109 109 109 109 109 109 109 109 109 109 109 109 109 109 109 109 109 109 109 109 109 109 109 109 109 109 109 109 109 109 109 109 109 109 109 109 109 109 109 109 109 109 109 109 109 109 109 109 109 
109 109 109 109 109 109 109 109 109 109 109 109 109 109 109 109 109 109 109 109 109 109 109 109 109 109 109 109 109 109 109 109 109 109 109 109 109 109 109 109 109 109 109 109 109 109 109 109 109 109 
109 109 109 109 109 109 109 109 109 109 109 109 109 109 109 109 109 109 109 109 109 109 109 109 109 109 109 109 109 109 109 109 109 109 109 109 109 109 109 109 109 109 109 109 109 109 109 109 109 109 
109 109 109 109 109 109 109 109 109 109 109 109 109 109 109 109 109 109 109 109 109 109 109 109 109 109 109 109 109 109 109 109 109 109 109 109 109 109 109 109 109 109 109 109 109 109 109 109 109 109 
109 109 109 109 109 109 109 109 109 109 109 109 109 109 109 136 137 137 137 137 137 137 137 137 137 137 137 137 137 137 138 109 109 109 109 109 109 109 109 109 109 109 109 109 109 109 109 109 109 109 
109 109 109 109 109 109 109 109 109 109 109 109 109 109 136 162 134 134 134 134 134 134 134 134 134 134 134 134 134 134 161 138 109 109 109 109 109 109 109 109 109 109 109 109 109 109 109 109 109 109 
109 109 109 109 109 109 109 109 109 109 109 109 109 136 162 134 134 134 134 134 134 134 134 134 134 134 134 134 134 134 134 161 138 109 109 109 109 109 109 109 109 109 109 109 109 109 109 109 109 109 
109 109 109 109 109 109 109 109 109 109 109 109 136 162 134 134 175 175 175 175 175 175 175 175 175 175 175 175 175 175 134 134 161 138 109 109 109 109 109 109 109 109 109 109 109 109 109 109 109 109 
109 109 109 109 109 109 109 109 109 109 109 109 142 134 134 175 175 175 175 175 175 175 175 175 175 175 175 175 175 175 175 134 134 161 138 109 109 109 109 109 109 109 109 109 109 109 109 109 109 109 
109 109 109 109 109 109 109 109 109 109 109 109 142 134 175 175 175 175 175 175 175 175 175 175 175 175 175 175 175 175 175 175 134 134 144 109 109 109 109 109 109 109 109 109 109 109 109 109 109 109 
109 109 109 109 109 109 109 109 109 109 109 109 142 175 175 175 175 175 175 175 175 175 175 175 175 175 175 175 175 175 175 175 175 134 144 109 109 109 109 109 109 109 136 137 138 109 109 109 109 109 
109 109 109 109 109 109 109 109 109 109 109 109 142 175 175 175 175 175 175 175 175 175 175 175 175 175 175 175 175 175 175 175 175 175 144 109 109 109 109 109 109 136 162 134 161 138 109 109 109 109 
109 109 109 109 109 109 109 109 109 109 109 136 162 175 175 175 175 175 175 175 175 175 175 175 175 175 175 175 175 175 175 175 175 175 144 109 109 109 109 109 136 162 134 175 134 161 138 109 109 109 
109 136 137 137 137 138 109 109 109 109 136 162 134 175 175 175 175 175 175 175 175 175 175 175 175 175 175 175 175 175 175 175 175 175 144 109 109 109 109 109 142 134 175 175 175 134 144 109 109 109 
109 142 134 134 134 144 109 109 109 136 162 134 134 175 175 175 175 175 175 175 175 175 175 175 175 175 175 175 175 175 175 175 175 175 144 109 109 109 109 109 142 175 175 175 175 175 144 109 109 109 
109 142 175 175 175 161 137 137 137 162 134 134 175 175 175 175 175 175 175 175 175 175 175 175 175 175 175 175 175 175 175 175 175 175 161 137 137 137 137 137 162 175 175 175 175 175 144 109 109 109 
109 142 175 175 175 134 134 134 134 134 134 175 175 175 175 175 175 175 175 175 175 175 175 175 175 175 175 175 175 175 175 175 175 175 134 134 134 134 134 134 134 175 175 175 175 175 144 109 109 109 
109 142 175 175 175 175 175 175 175 175 175 175 175 175 175 175 175 175 175 175 175 175 175 175 175 175 175 175 175 175 175 175 175 175 175 175 175 175 175 175 175 175 175 175 175 175 144 109 109 109 
109 142 175 175 175 155 149 149 149 156 175 175 175 175 175 175 175 175 175 175 175 175 175 175 175 175 175 175 175 175 175 175 175 175 155 149 149 149 149 149 156 175 175 175 175 175 144 109 109 109 
109 142 175 175 175 144 109 109 109 148 156 175 175 175 175 175 175 175 175 175 175 175 175 175 175 175 175 175 175 175 175 175 175 175 144 109 109 109 109 109 142 175 175 175 175 175 144 109 109 109 
109 148 156 175 155 150 109 109 109 109 148 156 175 175 175 175 175 175 175 175 175 175 175 175 175 175 175 175 175 175 175 175 175 175 144 109 109 109 109 109 142 175 175 175 175 175 144 109 109 109 
109 109 142 175 144 109 109 109 109 109 109 148 156 175 175 175 175 175 175 175 175 175 175 175 175 175 175 175 175 175 175 175 175 175 144 109 109 109 109 109 142 175 175 175 175 175 144 109 109 109 
109 109 142 158 144 109 109 109 109 109 109 109 142 175 175 175 175 175 175 175 175 175 175 175 175 175 175 175 175 175 175 175 175 175 144 109 109 109 109 109 148 149 156 175 155 149 150 109 109 109 
109 109 109 109 109 109 109 109 109 109 109 109 142 175 175 175 175 175 175 175 175 175 175 175 175 175 175 175 175 175 175 175 175 175 144 109 109 109 109 109 109 109 142 175 144 109 109 109 109 109 
109 109 109 109 109 109 109 109 109 109 109 109 142 175 175 175 175 175 175 175 175 175 175 175 175 175 175 175 175 175 175 175 175 155 150 109 109 109 109 109 109 109 142 175 144 109 109 109 109 109 
109 109 109 109 109 109 109 109 109 109 109 109 148 156 175 175 175 175 175 175 175 175 175 175 175 175 175 175 175 175 175 175 155 150 109 109 109 109 109 109 109 109 142 175 144 109 109 109 109 109 
109 109 109 109 109 109 109 109 109 109 109 109 109 148 156 175 175 175 175 175 175 175 175 175 175 175 175 175 175 175 175 155 150 109 109 109 109 109 109 109 109 109 142 175 144 109 109 109 109 109 
109 109 109 109 109 109 109 109 109 109 109 109 109 109 148 156 175 175 175 175 175 175 175 175 175 175 175 175 175 175 155 150 109 109 109 109 109 109 109 109 109 109 142 175 144 109 109 109 109 109 
109 109 109 109 109 109 109 109 109 109 109 109 109 109 109 148 149 149 149 149 149 149 149 149 149 149 149 149 149 149 150 109 109 109 109 109 109 109 109 109 109 109 142 175 144 109 109 109 109 109 
109 109 109 109 109 109 109 109 109 109 109 109 109 109 109 109 109 109 109 109 109 109 109 109 109 109 109 109 109 109 109 109 109 109 109 109 109 109 109 109 109 109 142 175 144 109 109 109 109 109 
109 109 109 109 109 109 109 109 109 109 109 109 109 109 109 109 109 109 109 109 109 109 109 109 109 109 109 109 109 109 109 109 109 109 109 109 109 109 109 109 109 109 142 175 144 109 109 109 109 109 
109 109 109 109 109 109 109 109 109 109 109 109 109 109 109 109 109 109 109 109 109 109 109 109 109 109 109 109 109 109 109 109 109 109 109 109 109 109 109 109 109 109 142 175 144 109 109 109 109 109 
109 109 109 109 109 109 109 109 109 109 109 109 109 109 109 109 109 109 109 109 109 109 109 109 109 109 109 109 109 109 109 109 109 109 109 109 109 109 109 109 109 109 142 175 144 109 109 109 109 109 
109 109 109 109 109 109 109 109 109 109 109 109 109 109 109 109 109 109 109 109 109 109 109 109 109 109 109 109 109 109 109 109 109 109 109 109 109 109 109 109 109 109 142 175 144 109 109 109 109 109 
109 109 109 109 109 109 109 109 109 109 109 109 109 109 109 109 109 109 109 109 109 109 109 109 109 109 109 109 109 109 109 109 109 109 109 109 109 109 109 109 109 109 142 175 144 109 109 109 109 109 
109 109 109 109 109 109 109 109 109 109 109 109 109 109 109 109 109 109 109 109 109 109 109 109 109 109 109 109 109 109 109 109 109 109 109 109 109 109 109 109 109 109 142 175 144 109 109 109 109 109 
109 109 109 109 109 109 109 109 109 109 109 109 109 109 109 109 109 109 109 109 109 109 109 109 109 109 109 109 109 109 109 109 109 109 109 109 109 109 109 109 109 109 142 175 144 109 109 109 109 109 
109 109 109 109 109 109 109 109 109 109 109 109 109 109 109 109 109 109 109 109 109 109 109 109 109 109 109 109 109 109 109 109 109 109 109 109 109 109 109 109 109 109 142 175 144 109 109 109 109 109 
109 109 109 109 109 109 109 109 109 109 109 109 109 109 109 109 109 109 109 109 109 109 109 109 109 109 109 109 109 109 109 109 109 109 109 109 109 109 109 109 109 109 142 157 144 109 109 109 109 109 
109 109 109 109 109 109 109 109 109 109 109 109 109 109 109 109 109 109 109 109 109 109 109 109 109 109 109 109 109 109 109 109 109 109 109 109 109 109 109 109 109 109 109 109 109 109 109 109 109 109 
109 109 109 109 109 109 109 109 109 109 109 109 109 109 109 109 109 109 109 109 109 109 109 109 109 109 109 109 109 109 109 109 109 109 109 109 109 109 109 109 109 109 109 109 109 109 109 109 109 109 
109 109 109 109 109 109 109 109 109 109 109 109 109 109 109 109 109 109 109 109 109 109 109 109 109 109 109 109 109 109 109 109 109 109 109 109 109 109 109 109 109 109 109 109 109 109 109 109 109 109 
109 109 109 109 109 109 109 109 109 109 109 109 109 109 109 109 109 109 109 109 109 109 109 109 109 109 109 109 109 109 109 109 109 109 109 109 109 109 109 109 109 109 109 109 109 109 109 109 109 109 
109 109 109 109 109 109 109 109 109 109 109 109 109 109 109 109 109 109 109 109 109 109 109 109 109 109 109 109 109 109 109 109 109 109 109 109 109 109 109 109 109 109 109 109 109 109 109 109 109 109 
