109 109 109 109 109 109 109 109 109 109 109 109 109 109 109 109 109 109 109 109 109 109 109 109 109 136 137 137 137 137 137 137 137 138 109 109 109 109 109 109 109 109 109 109 109 109 109 109 109 109 
109 109 109 109 109 109 109 109 109 109 109 109 109 109 109 109 109 109 109 109 109 109 109 109 109 142 134 134 134 134 134 134 134 144 109 109 109 109 109 109 109 109 109 109 109 109 109 109 109 109 
109 109 109 109 109 109 109 109 109 109 109 109 109 109 109 109 109 109 109 109 109 109 109 109 109 142 134 134 134 134 134 134 134 144 109 109 109 109 109 109 109 109 109 109 109 109 109 109 109 109 
109 109 109 109 109 109 109 109 109 109 109 109 109 109 109 109 109 109 109 109 109 109 109 109 109 142 167 171 171 171 171 171 168 144 109 109 109 109 109 109 109 109 109 109 109 109 109 109 109 109 
109 109 109 109 109 109 109 109 109 109 109 109 109 109 109 109 109 109 109 109 109 109 109 109 109 142 173 164 80 80 80 163 174 144 109 109 109 109 109 109 109 109 109 109 109 109 109 109 109 109 
109 109 109 109 109 109 109 109 109 109 109 109 109 109 109 109 109 109 109 109 109 109 109 109 109 148 156 173 164 80 163 174 155 150 109 109 109 109 109 109 109 109 109 109 109 109 109 109 109 109 
109 109 109 109 109 109 109 109 109 109 109 109 109 109 109 109 109 109 109 109 109 109 109 109 109 109 148 156 173 166 174 155 150 109 109 109 109 109 109 109 109 109 109 109 109 109 109 109 109 109 
109 109 109 109 109 109 109 109 109 109 109 109 109 109 109 109 109 109 109 109 109 109 109 109 109 109 109 148 156 175 155 150 109 109 109 109 109 109 109 109 109 109 109 109 109 109 109 109 109 109 
109 109 109 109 136 137 137 137 137 137 137 137 137 137 137 137 137 137 137 137 137 137 137 137 137 137 137 137 162 175 161 137 137 137 137 137 137 137 137 138 109 109 109 109 109 109 109 109 109 109 
109 109 109 109 142 134 134 134 134 134 134 134 134 134 134 134 134 134 134 134 134 134 134 134 134 134 134 134 134 175 134 134 134 134 134 134 134 134 134 161 138 109 109 109 109 109 109 109 109 109 
109 109 109 109 142 175 175 175 175 175 175 175 175 175 175 175 175 175 175 175 175 175 175 175 175 175 175 175 175 175 175 175 175 175 175 175 175 175 175 134 161 138 109 109 109 109 109 109 109 109 
109 109 109 109 142 175 175 175 175 175 175 175 175 175 175 175 175 175 175 175 175 175 175 175 175 175 175 175 175 175 175 175 175 175 175 175 175 175 175 175 134 161 138 109 109 109 109 109 109 109 
109 109 109 109 142 175 175 155 149 149 149 149 149 149 149 149 149 149 149 149 149 149 149 149 149 149 149 156 175 175 175 155 149 149 149 149 149 156 175 175 175 134 144 109 109 109 109 109 109 109 
109 109 109 109 142 175 175 144 109 109 109 109 109 109 109 109 109 109 109 109 109 109 109 109 109 109 109 148 156 175 155 150 109 109 109 109 109 148 156 175 175 175 144 109 109 109 109 109 109 109 
109 109 109 109 142 175 175 144 109 109 109 109 109 109 109 109 109 109 109 109 109 109 109 109 109 109 109 109 142 175 144 109 109 109 109 109 109 109 148 156 175 175 144 109 109 109 109 109 109 109 
109 109 109 109 142 175 175 144 109 109 109 109 109 109 109 109 109 109 109 109 109 109 109 109 109 109 109 109 142 157 144 109 109 109 109 109 109 109 109 142 175 175 144 109 109 109 109 109 109 109 
109 109 109 109 142 175 175 144 109 109 109 109 109 109 109 109 109 109 109 109 109 109 109 109 109 109 109 109 109 109 109 109 136 137 137 137 137 137 138 142 175 175 144 109 109 109 109 109 109 109 
109 109 109 109 142 175 175 144 109 109 109 109 109 109 109 109 109 109 109 109 109 109 109 109 109 109 109 109 109 109 109 109 142 134 134 134 134 134 144 142 175 175 144 109 109 109 109 109 109 109 
109 109 109 109 142 175 175 144 109 109 109 109 109 109 109 109 109 109 109 109 109 109 109 109 109 109 109 109 109 109 109 109 142 175 175 175 175 175 144 142 175 175 144 109 109 109 109 109 109 109 
109 109 109 109 142 175 175 144 109 109 109 109 109 109 109 109 142 151 144 109 109 109 109 109 109 109 109 109 109 109 109 109 142 175 175 175 175 175 144 142 175 175 144 109 109 109 109 109 109 109 
109 109 109 109 142 175 175 144 109 109 109 109 109 109 109 136 162 175 161 138 109 109 109 109 109 109 109 109 109 109 109 109 142 175 175 175 175 175 161 162 175 175 144 109 109 109 109 109 109 109 
109 109 109 109 142 175 175 144 109 109 109 109 109 109 109 142 134 175 134 144 109 109 109 109 109 109 109 109 109 109 109 109 142 175 175 175 175 175 134 134 175 175 144 136 137 137 137 137 138 109 
109 109 109 109 142 175 175 144 109 109 109 109 109 109 109 142 175 175 175 144 109 109 109 109 109 109 109 109 109 109 109 109 142 175 175 175 175 175 175 175 175 175 144 142 134 134 134 134 144 109 
109 109 109 109 142 175 175 144 109 109 109 109 109 109 109 142 175 175 175 144 109 109 109 109 109 109 109 109 109 109 109 109 142 175 175 175 175 175 155 156 175 175 161 162 167 171 171 168 144 109 
109 109 109 109 142 175 175 144 109 109 109 109 109 109 109 148 156 175 155 150 109 109 109 109 109 109 109 109 109 109 109 109 142 175 175 175 175 175 144 142 175 175 134 134 172 80 80 165 144 109 
109 109 109 109 142 175 175 144 109 109 109 109 136 137 137 137 162 175 161 137 137 137 138 109 109 109 109 109 109 109 109 109 142 175 175 175 175 175 144 142 175 175 175 175 172 80 80 165 144 109 
109 109 109 109 142 175 175 144 109 109 109 136 162 134 134 134 135 175 133 134 134 134 161 138 109 109 109 109 109 109 109 109 148 149 149 149 149 149 150 142 175 175 155 156 172 80 80 165 144 109 
109 109 109 109 142 175 175 144 109 109 136 162 134 134 134 134 135 175 133 134 134 134 134 161 138 109 109 109 109 109 109 109 109 109 109 109 109 109 109 142 175 175 144 142 173 166 166 174 144 109 
109 109 109 109 142 175 175 144 109 136 162 134 167 171 171 171 171 171 171 171 171 171 168 134 161 138 109 109 109 109 109 109 109 109 109 109 109 109 109 142 175 175 144 148 149 149 149 149 150 109 
109 109 109 109 142 175 175 144 109 142 134 134 172 163 166 166 166 166 166 166 166 164 165 134 134 144 109 109 109 109 109 109 109 109 109 109 109 109 109 142 175 175 144 136 137 137 137 137 138 109 
109 109 109 109 142 175 175 144 109 142 134 167 170 165 175 175 175 175 175 175 175 172 169 168 134 144 109 109 109 109 136 137 137 137 137 137 137 137 138 142 175 175 144 142 134 134 134 134 144 109 
109 109 109 109 142 175 175 144 109 142 167 170 163 174 175 175 175 175 175 175 175 173 164 169 168 144 109 109 109 109 142 134 134 134 134 134 134 134 144 142 175 175 161 162 167 171 171 168 144 109 
109 109 109 109 142 175 175 144 109 142 172 163 174 175 175 175 175 175 175 175 175 175 173 164 165 144 109 109 109 109 142 175 175 175 175 175 175 175 144 142 175 175 134 134 172 80 80 165 144 109 
109 109 109 109 142 175 175 144 109 142 172 165 175 175 175 175 175 175 175 175 175 175 175 172 165 144 109 109 109 109 142 175 175 175 175 175 175 175 144 142 175 175 175 175 172 80 80 165 144 109 
109 109 109 109 142 175 175 144 109 142 172 165 175 175 175 175 175 175 175 175 175 175 175 172 165 144 109 109 109 109 142 175 175 175 175 175 175 175 144 142 175 175 155 156 172 80 80 165 144 109 
109 109 109 109 142 175 175 144 109 142 172 165 175 175 175 175 175 175 175 175 175 175 175 172 165 144 109 109 109 109 142 175 175 175 175 175 175 175 144 142 175 175 144 142 173 166 166 174 144 109 
109 109 109 109 142 175 175 144 109 142 172 169 168 175 175 175 175 175 175 175 175 175 167 170 165 144 109 109 109 109 142 175 175 175 175 175 175 175 144 142 175 175 144 148 149 149 149 149 150 109 
109 109 109 109 142 175 175 144 109 142 173 164 169 168 175 175 175 175 175 175 175 167 170 163 174 144 109 109 109 109 142 175 175 175 175 175 175 175 144 142 175 175 144 109 109 109 109 109 109 109 
109 109 109 109 142 175 175 144 109 148 156 173 164 169 171 171 171 171 171 171 171 170 163 174 155 109 109 109 109 109 142 175 175 175 175 175 175 175 144 142 175 175 144 109 109 109 109 109 109 109 
109 109 109 109 142 175 175 144 109 109 148 156 173 166 166 166 166 166 166 166 166 166 174 155 150 109 109 109 109 109 148 156 175 175 175 175 175 155 150 142 175 175 144 109 109 109 109 109 109 109 
109 109 109 109 142 175 175 144 109 109 109 148 149 149 149 156 175 175 175 155 149 149 149 150 109 109 109 109 109 109 109 148 156 175 175 175 155 150 109 142 175 175 144 109 109 109 109 109 109 109 
109 109 109 109 142 175 175 144 109 109 109 109 109 109 109 148 156 175 155 150 109 109 109 109 109 109 109 109 109 109 109 109 148 156 175 155 150 109 109 142 175 175 144 109 109 109 109 109 109 109 
109 109 109 109 142 175 175 161 137 138 109 109 109 109 109 109 142 175 144 109 109 109 109 109 109 109 109 109 109 109 109 109 109 142 175 144 109 109 136 162 175 175 144 109 109 109 109 109 109 109 
109 109 109 109 142 175 175 134 134 161 138 109 109 109 109 136 162 175 161 138 109 109 109 109 109 109 109 109 109 109 109 109 109 142 175 144 109 136 162 134 175 175 144 109 109 109 109 109 109 109 
109 109 109 109 142 175 175 175 175 134 161 137 137 137 137 162 134 175 134 161 137 137 137 137 137 137 137 137 137 137 137 137 137 162 175 161 137 162 134 175 175 155 150 109 109 109 109 109 109 109 
109 109 109 109 142 175 175 175 175 134 134 134 134 134 134 134 175 175 175 134 134 134 134 134 134 134 134 134 134 134 134 134 134 134 175 134 134 134 175 175 155 150 109 109 109 109 109 109 109 109 
109 109 109 109 142 175 175 175 175 175 175 175 175 175 175 175 175 175 175 175 175 175 175 175 175 175 175 175 175 175 175 175 175 175 175 175 175 175 175 155 150 109 109 109 109 109 109 109 109 109 
109 109 109 109 142 175 175 175 175 175 175 175 175 175 175 175 175 175 175 175 175 175 175 175 175 175 175 175 175 175 175 175 175 175 175 175 175 175 155 150 109 109 109 109 109 109 109 109 109 109 
109 109 109 109 148 149 149 149 149 149 149 149 149 149 149 149 149 149 149 149 149 149 149 149 149 149 149 149 149 149 149 149 149 149 149 149 149 149 150 109 109 109 109 109 109 109 109 109 109 109 
109 109 109 109 109 109 109 109 109 109 109 109 109 109 109 109 109 109 109 109 109 109 109 109 109 109 109 109 109 109 109 109 109 109 109 109 109 109 109 109 109 109 109 109 109 109 109 109 109 109 
