81 81 81 81 81 81 81 81 81 81 81 81 81 81 81 81 81 81 81 81 81 81 81 81 81 81 81 81 81 81 81 81 81 81 81 81 81 81 81 81 81 81 81 81 81 81 81 81 81 81 81 81 81 81 61 81 81 81 81 81 81 81 81 81 81 81 81 81 81 81 81 81 81 81 81 81 81 81 81 81 81 81 81 81 81 81 81 81 81 81 81 81 81 81 81 81 81 81 81 81 
81 81 81 81 81 81 81 81 81 81 81 81 81 81 81 81 81 81 81 81 81 81 81 81 81 81 81 81 81 81 81 81 81 61 81 81 81 81 81 81 81 81 81 81 81 81 81 81 81 81 81 81 81 81 81 81 81 81 81 81 81 81 81 81 81 81 81 81 81 81 61 81 81 81 81 81 81 81 81 81 81 81 81 81 81 81 81 81 81 81 81 81 81 81 81 81 81 81 81 81 
81 81 81 81 81 81 81 81 81 81 81 81 81 81 81 81 81 81 81 81 81 81 81 81 81 81 81 81 81 81 81 81 81 81 81 81 81 81 81 81 81 81 81 81 81 81 81 81 81 81 81 81 81 81 81 81 81 61 81 81 81 81 81 81 81 81 81 81 81 81 81 81 81 81 81 81 81 81 81 81 81 81 81 81 81 81 81 81 81 81 81 81 81 81 81 81 81 81 81 81 
81 81 81 81 81 81 81 81 81 81 81 81 81 81 81 81 81 81 81 81 61 81 81 81 81 81 81 81 81 81 81 81 81 81 81 81 81 81 81 81 81 81 81 81 81 61 81 81 81 81 81 81 81 81 81 81 81 81 81 81 81 81 81 81 81 81 81 81 81 81 81 81 81 81 81 81 81 81 81 81 61 81 81 81 81 81 81 81 81 81 81 81 81 81 61 81 81 81 81 81 
81 81 81 81 81 81 81 81 81 81 81 81 81 81 81 81 81 81 81 81 81 81 81 81 81 81 81 81 81 81 81 81 81 81 81 81 81 81 81 81 61 81 81 81 81 81 81 81 81 81 81 61 81 81 81 81 81 81 81 81 81 81 61 81 81 81 81 81 81 81 81 81 81 81 81 61 81 81 81 81 81 81 81 81 81 81 81 81 61 81 81 81 81 81 81 81 81 81 81 81 
81 81 81 81 81 81 81 81 81 81 61 81 81 81 81 81 81 81 81 81 81 81 81 81 81 81 81 81 81 81 81 81 81 81 81 81 81 81 81 81 81 81 81 81 81 81 81 81 81 81 81 81 81 81 81 81 81 81 61 81 81 81 81 81 81 81 81 81 81 81 81 81 81 81 81 81 81 81 81 81 81 81 81 81 81 81 81 81 81 81 81 81 81 81 81 81 61 81 81 81 
81 81 81 81 81 81 81 81 81 81 81 81 81 81 81 81 81 81 81 81 81 81 81 81 81 81 81 81 81 81 81 81 61 81 81 81 81 81 81 81 81 81 81 81 81 81 81 81 81 81 81 81 81 81 81 81 81 81 81 81 81 81 81 81 81 81 81 81 81 81 81 81 81 81 81 81 81 81 81 81 81 81 81 81 81 81 81 81 81 81 81 81 61 81 81 81 81 81 81 81 
81 81 81 81 81 81 81 81 81 81 81 81 81 81 81 81 81 81 81 81 81 81 81 81 81 81 81 81 81 81 81 81 81 81 81 81 81 81 81 81 81 81 81 81 81 81 81 81 81 81 81 81 81 81 81 81 81 81 81 81 81 81 81 81 81 81 81 81 81 81 81 81 81 81 81 81 81 81 81 81 81 81 81 81 81 81 81 81 81 81 81 81 81 81 81 81 81 81 81 81 
81 81 81 81 81 81 81 81 81 81 81 81 81 81 81 81 81 81 81 81 81 81 81 61 81 81 81 81 81 81 81 81 81 81 81 81 81 81 14 3 3 3 3 3 3 3 3 3 3 3 3 3 3 3 3 3 3 3 3 3 3 3 3 3 3 3 3 3 3 15 81 81 81 81 81 81 61 81 81 81 81 81 81 81 81 81 81 81 81 81 81 81 81 81 81 81 81 81 81 81 
81 81 81 81 81 81 81 81 81 81 81 81 81 81 81 61 81 81 81 81 81 81 81 81 81 81 81 81 81 81 81 81 81 81 81 81 81 54 34 4 3 3 3 3 3 3 3 3 3 3 3 3 3 3 3 3 3 3 3 3 3 3 3 3 3 3 3 3 5 35 55 81 81 81 81 81 81 81 81 81 81 81 81 61 81 81 81 81 81 81 81 81 81 81 81 81 81 81 81 81 
81 81 81 81 61 61 81 81 81 81 81 81 81 81 81 81 81 81 81 81 81 81 81 81 81 61 81 81 81 81 81 81 81 81 81 81 81 54 34 34 4 3 3 3 3 3 3 3 3 3 3 3 3 3 3 3 3 3 3 3 3 3 3 3 3 3 3 5 35 35 55 81 81 81 81 81 81 81 81 81 81 81 81 81 81 81 81 81 81 81 81 81 81 81 81 81 81 81 81 81 
81 81 81 81 81 81 81 81 81 81 81 81 81 81 81 81 81 81 81 81 81 81 81 81 81 81 81 81 81 81 81 81 81 81 81 81 81 54 34 34 34 23 23 23 23 23 23 23 23 23 23 23 23 23 23 23 23 23 23 23 23 23 23 23 23 23 23 35 35 35 55 81 81 61 81 81 81 81 81 81 81 81 81 81 81 81 81 81 81 81 81 61 81 81 81 81 81 81 81 81 
81 81 81 81 81 81 81 81 81 81 81 81 81 81 81 81 81 81 81 81 81 81 81 81 81 81 81 81 81 81 81 81 81 81 81 81 81 54 34 34 34 23 23 23 23 23 23 23 23 23 23 23 23 23 23 23 23 23 23 23 23 23 23 23 23 23 23 35 35 35 55 81 81 81 81 81 81 81 81 81 81 81 81 81 81 81 81 81 81 81 81 81 81 81 81 81 81 81 81 81 
81 81 81 81 81 81 81 81 81 81 81 81 81 81 81 81 81 81 81 81 81 81 81 81 81 81 81 81 81 81 81 81 81 81 81 81 81 54 34 34 34 23 23 23 23 23 23 23 23 23 23 23 23 23 23 23 23 23 23 23 23 23 23 23 23 23 23 35 35 35 55 81 81 81 81 81 81 81 81 81 81 81 81 81 81 81 81 81 81 81 81 81 81 81 81 81 81 61 81 81 
81 81 81 81 81 81 81 61 81 81 81 81 81 81 81 81 81 81 81 81 81 81 81 81 81 81 81 81 81 81 81 81 81 81 81 81 81 54 34 34 34 23 23 23 23 23 23 23 23 23 23 23 23 23 23 23 23 23 23 23 23 23 23 23 23 23 23 67 5 5 15 81 81 81 81 81 81 81 81 81 81 81 81 81 81 81 81 81 81 81 81 81 81 81 81 81 81 81 81 81 
81 81 81 81 81 81 81 81 81 81 81 81 81 81 81 81 81 61 81 81 81 81 81 81 81 81 81 81 81 81 81 81 81 81 81 81 81 14 4 23 34 23 23 23 23 23 23 23 23 23 23 23 23 23 23 23 23 23 23 23 23 23 23 23 23 23 77 23 67 5 5 3 3 3 3 3 3 3 15 81 81 81 81 61 81 81 81 81 81 81 81 81 61 81 81 81 81 81 81 81 
81 81 81 81 81 81 81 81 81 81 81 61 81 81 81 81 81 81 81 81 81 81 81 81 81 81 81 81 81 81 81 81 81 81 81 81 54 34 34 4 23 23 23 23 23 23 23 23 23 23 23 23 23 23 23 23 23 23 23 23 23 23 23 23 43 23 23 77 23 67 5 3 3 3 3 3 3 5 35 55 81 81 81 81 81 81 81 61 81 81 81 81 81 81 81 81 81 81 81 81 
81 81 81 81 81 81 81 81 81 81 81 81 81 81 81 81 81 81 81 81 81 81 81 81 81 81 81 81 81 61 81 81 81 81 81 81 54 34 34 34 23 23 23 23 23 23 23 23 23 23 23 23 23 23 23 23 23 23 23 23 23 23 43 85 18 18 18 18 18 86 67 3 3 3 3 3 5 35 35 55 81 81 81 81 81 81 81 81 81 81 81 81 81 81 81 81 81 61 81 81 
81 81 81 81 81 81 81 81 81 81 81 81 81 81 81 81 81 81 81 81 81 81 81 81 81 81 81 81 81 81 81 81 81 81 81 81 54 34 34 34 23 23 23 23 23 23 23 23 23 23 23 23 23 23 23 23 23 23 23 23 23 23 23 19 6 9 9 9 7 16 86 67 67 67 67 67 35 35 35 55 81 81 81 81 81 81 81 81 81 81 81 81 81 81 81 81 81 81 81 81 
81 81 81 81 81 81 81 81 81 81 81 81 81 81 81 81 81 81 81 81 81 81 81 81 81 81 81 81 81 81 81 81 81 81 81 81 54 34 34 0 23 23 23 23 23 23 23 23 23 23 23 23 23 23 23 23 23 23 23 23 23 23 23 19 8 23 33 77 95 7 16 86 43 43 23 67 35 35 35 55 81 81 81 81 81 81 81 81 81 81 81 81 81 81 81 81 81 81 81 81 
81 81 81 81 81 81 81 81 81 81 81 81 81 81 81 81 81 81 81 81 81 81 81 81 81 81 81 81 81 81 81 81 81 81 81 81 54 34 34 10 0 23 23 23 23 23 23 23 23 23 23 23 23 23 23 23 23 23 23 23 23 23 23 19 8 23 77 23 33 95 7 16 86 23 43 67 35 35 35 55 81 81 81 81 81 81 81 81 81 81 81 81 81 81 81 81 81 81 81 81 
81 81 81 81 81 81 81 81 81 81 81 81 81 81 81 81 81 81 81 81 81 81 81 81 81 81 81 81 81 81 81 81 81 81 81 81 14 4 23 10 10 0 23 23 23 23 23 23 23 23 23 23 23 23 23 23 23 23 23 23 23 23 23 95 96 67 13 33 23 33 95 7 8 43 43 23 67 5 5 15 81 81 81 81 81 81 81 81 81 81 81 81 81 61 81 81 81 81 81 81 
81 81 81 81 81 81 81 81 81 81 81 61 81 81 81 61 81 81 81 81 81 14 3 3 3 3 3 3 3 3 3 3 3 3 3 3 4 23 23 20 10 10 0 1 1 1 1 1 1 1 1 1 1 1 1 1 1 1 1 1 1 1 1 53 53 1 67 13 33 23 33 19 8 33 43 23 23 67 5 5 3 3 3 3 3 3 15 81 81 81 81 81 81 81 81 81 81 81 81 81 
81 81 81 81 61 81 81 81 81 81 81 81 81 81 81 81 81 81 81 81 54 34 77 67 67 67 67 4 3 3 3 3 3 3 3 3 43 23 23 23 20 10 10 11 11 11 11 11 11 11 11 11 11 11 11 11 11 11 11 11 11 11 11 63 63 11 0 67 13 33 23 19 16 86 23 43 23 23 67 5 3 3 3 3 3 5 35 55 81 81 81 81 81 81 81 81 81 81 81 81 
81 81 81 81 81 81 81 81 81 81 81 81 81 81 81 81 81 81 81 81 54 34 67 23 23 23 67 34 23 23 23 23 23 23 23 23 23 23 23 23 23 20 10 11 11 11 11 11 11 11 11 11 11 11 11 11 11 11 11 11 11 11 11 63 63 11 10 0 67 13 23 19 80 16 86 23 43 43 23 67 3 3 3 3 5 35 35 55 81 81 81 81 81 81 81 81 81 81 81 81 
81 81 81 81 81 81 81 81 81 81 81 81 81 81 81 81 81 81 81 81 54 34 67 23 23 23 67 34 23 23 23 23 23 23 23 23 23 23 23 23 23 23 20 21 21 21 21 21 21 21 21 21 21 21 21 21 21 21 21 21 21 21 21 63 63 21 10 10 34 67 33 19 80 80 16 18 18 18 18 18 18 18 18 86 35 35 35 55 81 81 81 81 81 81 81 81 81 81 81 81 
81 81 81 81 81 81 81 81 81 81 81 81 81 81 81 81 81 81 81 81 54 34 67 23 23 23 67 34 23 23 23 23 23 23 23 23 23 23 23 23 23 23 23 23 23 23 23 23 23 23 23 23 23 23 23 23 23 23 23 23 23 23 23 74 74 23 20 10 34 67 33 19 80 80 80 80 80 80 80 80 80 80 76 8 35 35 35 55 81 81 81 61 81 81 81 81 81 81 81 81 
81 81 81 81 81 81 81 81 81 81 81 81 81 81 81 81 81 81 81 81 54 34 67 23 23 23 67 34 23 23 23 23 23 23 23 23 23 23 23 23 23 23 23 23 23 23 23 23 23 23 23 23 23 23 23 23 23 23 23 23 23 23 23 85 86 23 23 20 34 67 13 19 80 80 80 80 80 76 80 76 80 80 80 8 35 35 35 55 81 81 81 81 81 81 81 81 81 81 61 81 
81 81 81 81 81 81 81 81 81 61 81 81 81 81 81 81 81 81 81 81 54 34 67 23 23 23 67 34 23 23 23 23 23 23 23 23 23 23 23 23 23 23 23 23 23 23 23 23 23 23 23 23 23 23 23 23 23 23 23 23 23 23 23 19 8 23 23 23 34 67 33 95 7 80 80 76 80 80 80 80 80 80 80 8 35 35 35 55 81 81 81 81 81 81 81 81 81 81 81 81 
81 81 81 81 81 81 81 81 81 81 81 81 81 81 81 81 81 81 81 81 54 34 67 23 23 23 67 34 23 23 23 23 23 23 23 23 23 23 23 23 23 23 23 23 23 23 23 23 23 23 23 23 23 23 23 23 23 23 23 23 23 23 23 19 8 23 23 23 0 67 43 33 95 7 80 80 80 80 80 80 76 80 80 8 35 35 35 55 81 81 61 81 81 81 81 81 81 81 81 81 
81 81 81 81 81 81 81 81 81 81 81 81 81 81 81 81 81 81 81 81 54 34 67 23 23 23 67 0 23 23 23 23 23 23 23 23 23 23 23 23 23 23 23 23 23 23 23 23 23 23 23 23 23 23 23 23 23 23 23 23 23 23 23 19 8 23 23 23 10 0 67 43 33 95 7 80 76 80 80 80 80 80 80 8 35 35 35 55 81 81 81 81 81 81 81 81 81 81 81 81 
81 81 81 81 61 81 81 81 81 81 81 81 81 81 81 81 81 81 81 81 54 34 67 23 23 23 67 20 0 23 23 23 23 23 23 23 23 23 23 23 23 23 23 23 23 23 23 23 23 23 23 23 23 23 23 23 23 23 23 23 23 23 23 19 8 23 23 23 10 10 0 67 33 43 95 7 80 80 80 76 80 80 76 8 35 35 35 55 81 81 81 81 81 81 81 81 81 81 81 81 
81 81 81 81 81 81 81 81 81 81 81 81 81 81 81 81 81 81 81 81 14 43 67 23 23 23 67 13 20 0 1 1 1 1 23 23 23 23 23 23 23 23 23 23 23 23 23 23 23 23 23 23 85 18 18 18 18 18 18 18 18 18 18 17 8 23 23 23 20 10 10 0 67 67 67 95 9 9 9 9 9 9 9 96 35 35 35 55 81 81 81 81 81 81 81 81 81 81 81 81 
81 81 81 81 81 81 81 81 81 81 81 81 81 14 3 3 3 3 3 3 43 67 23 23 23 23 77 23 13 20 21 21 90 21 0 23 23 23 23 23 23 23 23 23 23 23 23 23 23 23 23 23 19 6 9 9 9 9 9 9 9 9 9 9 96 23 23 23 23 20 10 10 0 1 1 1 1 1 1 1 1 1 1 1 2 35 35 55 81 81 81 81 81 81 81 81 81 81 81 81 
81 81 81 81 81 81 81 81 81 81 81 81 54 34 67 67 67 67 67 67 67 23 23 23 23 23 67 43 43 23 23 23 23 23 20 0 23 23 23 23 23 43 23 23 23 43 23 23 23 23 23 23 19 8 23 23 23 23 23 23 23 23 23 23 23 23 23 23 23 23 20 10 10 11 11 11 11 11 11 11 11 11 11 11 12 35 35 55 81 81 81 81 81 81 81 81 81 81 81 81 
81 81 81 81 81 81 81 81 81 81 81 81 54 34 67 23 23 23 23 23 23 23 23 23 23 23 67 23 23 23 33 23 23 33 13 20 34 23 23 23 23 23 23 23 23 23 23 23 23 23 23 23 19 8 23 23 23 23 23 23 23 23 23 23 23 23 23 23 23 23 23 20 10 11 11 11 11 11 11 11 11 11 11 11 12 35 35 55 81 81 81 81 81 81 81 81 81 81 81 81 
81 81 81 81 81 81 81 81 81 81 81 81 54 34 67 85 18 86 67 23 100 101 102 23 23 23 67 13 43 23 23 13 43 13 23 77 34 23 23 23 23 23 23 23 23 23 23 23 23 23 23 23 19 8 23 23 23 23 23 23 23 23 23 23 23 23 23 23 23 23 23 23 20 21 21 21 21 21 21 21 21 21 21 21 22 35 35 55 81 81 81 81 81 81 81 61 81 81 81 81 
81 81 81 81 81 81 81 81 81 81 81 81 54 34 67 19 80 8 67 23 103 104 105 23 23 23 67 23 13 23 33 23 23 33 67 67 34 23 23 23 23 23 23 23 23 23 23 23 23 23 23 23 19 8 23 23 23 23 23 23 23 23 23 23 23 23 23 23 23 23 23 23 23 23 1 1 1 1 1 1 1 1 1 1 1 2 35 55 81 81 81 81 81 81 81 81 81 81 81 81 
81 81 81 81 81 81 81 81 81 81 81 81 54 34 67 19 80 8 67 67 106 107 108 67 67 67 43 67 77 77 77 67 67 67 67 67 34 23 23 43 23 23 43 23 23 23 43 23 23 23 23 23 19 8 23 23 23 23 23 23 23 23 23 23 23 23 23 23 23 23 23 23 2 21 21 21 21 21 21 21 21 21 21 21 21 22 35 55 81 81 81 81 81 81 81 81 81 81 81 81 
81 81 81 81 81 81 81 81 81 81 81 81 54 34 67 19 80 16 18 18 18 18 18 18 18 18 86 67 4 3 3 3 3 3 3 3 23 85 18 18 86 23 23 23 23 23 23 23 23 23 23 23 19 8 23 23 23 23 23 23 23 23 23 23 23 23 23 23 23 23 23 2 22 1 1 1 1 1 1 1 1 1 1 1 1 1 2 55 81 81 81 81 81 81 81 81 81 81 81 81 
81 81 81 81 81 81 81 81 81 81 81 81 54 34 67 19 60 80 80 80 80 80 80 80 80 80 8 67 34 23 23 43 23 23 23 23 23 95 9 7 16 18 18 18 18 18 18 18 18 18 18 18 17 8 23 23 23 23 23 23 23 23 23 23 23 23 23 23 23 23 35 22 2 31 31 31 31 31 31 31 31 31 31 31 31 31 32 81 81 81 81 81 81 81 81 81 81 81 81 81 
81 81 81 81 81 81 81 81 61 81 81 81 54 34 67 19 80 80 60 80 80 80 80 80 80 80 8 67 0 1 1 1 1 1 1 1 1 1 43 95 9 9 9 9 9 9 9 9 9 9 9 9 7 8 23 23 23 23 23 23 23 23 23 23 23 23 23 23 23 23 35 35 32 81 81 81 81 81 81 81 81 81 81 81 81 81 81 81 81 81 81 81 81 81 81 81 81 81 61 81 
81 81 81 81 81 81 81 81 81 81 81 81 54 34 67 19 80 80 80 80 80 80 80 80 80 80 8 67 20 21 21 21 21 21 21 21 21 21 0 43 23 23 23 23 23 23 23 23 23 23 23 23 19 8 23 23 23 23 23 23 23 23 23 23 23 23 23 23 23 23 35 35 55 81 81 81 81 81 81 81 81 81 81 81 81 81 81 81 81 81 81 81 81 81 81 81 81 81 81 81 
81 81 81 81 61 81 81 81 81 81 81 81 54 34 67 95 9 9 9 7 80 80 6 9 9 9 96 67 67 67 67 67 67 67 67 67 67 77 20 34 67 23 23 23 23 23 23 23 23 23 23 23 19 8 23 23 23 23 23 23 23 23 23 23 23 23 23 23 23 23 35 35 55 81 81 81 81 81 81 81 81 81 81 81 81 81 81 81 81 81 81 81 81 81 81 81 81 81 81 81 
81 81 81 81 81 81 81 81 81 81 81 81 54 34 23 67 67 67 67 19 80 80 16 18 18 18 18 18 18 18 18 18 18 18 18 18 18 86 67 34 67 23 23 23 23 23 23 23 23 23 23 23 19 8 23 23 23 23 23 23 23 23 23 23 23 23 23 23 23 23 35 35 55 81 81 81 81 81 81 81 81 81 81 81 81 81 81 81 81 81 81 81 81 81 81 81 81 81 81 81 
81 81 81 81 81 81 81 81 81 81 81 81 54 34 23 23 23 23 43 19 80 80 80 80 80 80 80 80 80 80 60 80 60 80 80 80 80 8 67 34 67 23 23 43 23 23 23 43 23 23 23 23 19 8 23 23 23 23 23 23 23 23 23 23 23 23 23 23 23 23 35 35 55 81 81 61 81 81 81 81 61 81 81 81 81 81 61 81 81 81 81 81 81 81 61 81 81 81 81 81 
81 81 81 81 81 81 81 81 81 81 81 81 54 34 23 23 23 23 67 95 9 9 9 9 9 9 9 9 9 9 9 9 9 9 9 7 80 8 67 34 67 23 23 23 23 23 23 23 23 23 23 23 19 8 23 23 23 23 23 23 23 23 23 23 23 23 23 23 23 23 35 35 55 81 81 81 81 81 81 81 81 81 81 81 81 81 81 81 81 81 81 81 81 81 81 81 81 81 81 81 
81 81 81 81 81 81 81 81 81 81 81 81 54 34 23 23 23 23 23 67 67 67 67 67 67 67 67 67 67 67 67 67 67 67 23 19 80 8 67 34 67 23 23 23 23 23 23 23 23 23 23 23 19 8 23 23 23 23 23 23 23 23 23 23 23 23 1 1 1 1 2 35 55 81 81 81 81 81 61 81 81 81 81 81 81 81 81 81 81 81 81 81 81 81 81 81 81 81 81 81 
81 81 81 81 81 81 81 81 81 81 81 81 54 34 23 23 23 23 23 23 23 23 23 23 23 23 23 23 23 23 23 23 23 23 67 19 80 8 67 34 67 23 23 23 23 23 23 23 23 23 23 67 19 8 23 23 23 23 23 23 23 23 23 23 23 2 21 21 21 21 22 35 55 81 81 81 81 81 81 81 81 81 81 81 81 81 81 61 81 81 81 81 81 81 81 81 81 81 81 81 
81 81 81 61 81 81 81 81 61 81 81 81 54 34 23 23 23 23 23 23 23 23 23 23 23 23 23 23 23 23 23 23 23 43 23 19 80 8 67 34 67 23 23 23 23 23 23 23 23 23 23 67 19 8 23 23 23 23 23 23 23 23 23 23 2 22 1 1 1 1 1 2 55 81 81 81 81 81 81 81 81 81 81 81 81 81 81 81 81 81 81 81 81 81 81 81 81 81 81 81 
81 81 81 81 81 81 81 81 81 81 81 81 54 0 1 1 1 1 1 1 1 1 1 1 1 1 1 1 1 1 1 1 23 82 67 19 80 8 67 34 67 23 23 23 23 23 23 23 23 23 23 67 19 8 23 23 23 23 23 23 23 23 23 35 22 2 31 31 31 31 31 32 81 81 81 81 81 81 81 81 81 81 81 81 81 81 81 81 81 81 81 81 81 61 81 81 81 81 81 81 
81 81 81 81 81 81 81 81 81 81 81 81 81 30 31 31 31 31 31 31 31 31 31 31 31 31 31 31 31 31 31 31 0 23 67 19 80 8 67 34 67 23 23 23 23 23 23 23 23 23 23 67 19 8 23 23 23 23 23 23 23 23 23 35 35 32 81 81 81 81 81 81 81 81 81 81 81 81 61 81 81 81 81 61 81 81 81 81 81 81 81 81 81 81 81 81 81 81 81 81 
81 81 81 81 81 81 81 81 81 81 81 81 81 81 81 81 81 81 81 81 81 81 81 81 81 81 81 81 81 81 81 81 30 34 67 19 80 8 67 34 67 23 23 23 23 23 23 23 23 23 23 67 19 8 23 23 23 23 23 23 23 23 23 35 35 55 81 81 81 81 81 81 81 81 61 81 81 81 81 81 81 81 81 81 81 81 81 81 81 81 81 81 81 81 81 81 81 81 81 81 
81 81 81 81 81 81 81 81 81 81 81 81 81 81 81 81 81 81 61 81 81 81 61 81 81 81 81 61 81 81 81 81 54 34 67 19 60 8 67 34 67 67 23 23 23 23 23 23 23 23 23 23 19 8 23 23 23 23 23 23 23 23 23 35 35 55 81 81 81 81 61 81 81 81 81 81 81 81 81 81 81 81 81 81 81 81 81 81 81 81 81 81 81 81 81 81 81 81 81 81 
81 81 81 81 81 61 81 81 81 81 61 81 81 81 81 81 61 81 81 81 81 61 81 81 81 81 81 81 81 81 61 81 54 34 67 19 80 8 67 0 1 1 67 23 23 23 23 23 23 23 23 67 19 8 23 23 23 23 23 23 23 23 23 35 35 55 81 81 81 81 81 81 81 81 81 81 81 81 81 81 81 81 81 81 81 81 81 81 81 81 81 81 81 81 81 81 81 81 81 81 
81 81 81 81 81 81 81 81 81 81 81 81 81 81 81 81 81 81 81 81 81 81 81 81 61 81 61 81 61 81 81 81 54 34 67 19 80 8 67 20 21 21 0 67 23 23 23 23 23 23 23 67 19 8 23 23 23 23 23 23 23 23 23 35 35 55 81 81 81 61 81 81 81 81 81 81 81 81 81 81 81 81 81 81 81 81 81 81 81 81 81 81 81 81 81 81 81 81 81 81 
81 81 81 81 81 81 81 81 81 81 81 81 81 81 61 81 81 81 81 61 81 81 61 81 81 81 81 81 81 81 81 81 54 34 67 19 80 8 67 67 67 67 20 0 67 23 23 23 23 23 23 67 19 8 23 23 23 23 23 23 23 23 23 23 5 15 81 81 81 81 81 81 81 81 81 81 81 81 81 81 81 81 81 81 81 81 81 81 81 81 81 61 81 81 81 81 81 81 81 81 
81 81 81 81 81 81 81 81 81 81 81 81 81 81 81 81 81 81 81 81 81 81 81 81 81 81 81 81 81 81 81 81 54 34 67 19 60 16 18 18 18 86 67 20 0 67 23 23 23 23 23 67 19 8 23 23 23 23 23 23 23 23 23 23 23 5 3 3 3 3 3 3 3 3 3 3 3 3 3 3 3 3 3 15 81 81 81 81 81 81 81 81 81 81 81 81 81 81 81 61 
81 81 81 81 81 81 81 81 81 81 81 81 81 81 81 81 81 81 61 81 81 61 81 81 81 61 81 81 81 61 81 81 54 34 67 19 80 80 80 80 60 16 86 67 20 0 67 23 23 23 23 67 19 8 23 23 23 23 23 23 23 23 23 23 23 23 3 3 3 3 3 3 3 3 3 3 3 3 3 3 3 3 5 35 55 81 81 81 81 81 81 81 81 81 81 81 81 81 81 81 
81 81 81 81 61 81 81 81 81 81 81 81 61 81 81 81 61 81 81 81 81 81 81 81 81 81 81 81 81 81 81 81 54 34 67 95 9 9 9 9 7 60 16 86 67 20 0 67 23 23 23 67 19 8 23 23 23 23 23 23 23 23 23 23 23 23 23 23 23 23 23 23 23 23 23 23 23 23 23 23 23 23 35 35 55 81 81 81 81 81 81 81 81 81 81 81 81 81 81 81 
81 81 81 81 81 81 81 81 81 61 81 81 81 81 81 81 81 81 81 81 81 61 81 81 81 81 81 81 81 81 81 61 54 34 67 67 67 67 67 67 95 7 60 16 86 67 20 0 67 23 23 67 19 8 23 23 23 23 23 23 23 23 23 23 23 23 23 23 23 23 23 23 23 23 23 23 23 23 23 23 23 23 35 35 55 81 81 81 81 81 61 81 81 81 81 81 81 81 81 81 
81 81 81 81 81 81 81 81 81 81 81 81 81 81 61 81 81 81 81 61 81 81 81 81 81 81 61 81 81 81 61 81 14 67 23 23 23 23 23 23 67 95 7 60 16 86 67 20 0 67 23 67 19 8 23 23 23 23 23 23 23 23 23 23 23 23 23 23 23 23 23 23 23 23 23 23 23 23 23 23 23 23 35 35 55 81 61 81 81 81 81 81 81 81 81 81 61 81 81 81 
81 81 81 81 81 81 81 81 81 81 81 81 81 81 81 81 81 81 61 81 81 81 81 61 81 81 14 3 3 3 3 3 43 67 23 23 23 23 23 23 23 67 95 7 60 16 86 67 20 0 67 67 19 8 23 23 23 23 23 23 23 23 23 23 23 23 23 23 23 23 23 23 23 23 23 23 23 23 23 23 23 23 35 35 55 81 81 81 81 81 81 81 81 81 81 81 81 81 81 81 
81 81 81 81 81 81 81 81 81 81 81 81 81 81 81 81 81 81 61 81 81 81 81 81 81 54 34 4 3 3 3 3 3 3 3 3 3 3 5 23 23 23 67 95 7 60 16 86 67 20 34 67 19 8 23 23 23 23 23 23 23 23 23 23 23 23 23 23 23 23 23 23 23 23 23 23 23 23 23 23 23 23 35 35 55 81 81 81 81 81 81 81 81 81 81 81 81 81 81 81 
81 81 61 81 81 81 81 81 81 81 81 81 61 81 81 61 81 81 81 81 81 81 81 81 81 54 34 34 67 67 67 67 67 67 67 67 67 67 67 5 23 23 23 67 95 7 60 16 86 44 34 67 19 8 23 23 23 23 23 23 23 23 23 23 23 23 23 23 23 23 23 23 23 23 23 23 23 23 23 23 23 23 35 35 55 81 81 81 81 81 81 81 81 81 81 81 81 81 81 81 
81 81 81 81 81 81 81 81 81 81 81 81 81 81 81 81 81 81 81 81 61 81 81 81 81 54 34 34 13 33 43 85 18 18 18 18 18 18 86 67 5 23 23 23 67 95 7 80 8 44 34 67 19 8 23 23 23 23 23 23 23 23 23 23 23 23 23 23 23 23 23 23 23 23 23 23 23 23 23 23 23 23 23 5 15 81 81 81 81 81 81 81 81 81 81 61 81 81 81 81 
81 81 81 81 81 61 81 81 81 81 81 81 81 81 81 81 81 81 81 81 81 81 81 81 61 54 34 34 23 23 23 19 80 80 80 80 80 80 8 67 35 45 23 23 23 67 19 80 8 44 34 67 19 8 23 23 23 23 23 23 23 23 23 23 23 23 23 23 23 23 23 23 23 23 23 23 23 23 23 23 23 23 23 23 5 3 15 81 81 81 81 81 81 81 81 81 81 81 81 81 
81 81 81 81 81 81 81 81 81 61 81 81 81 61 81 81 81 61 81 81 81 81 81 81 81 54 34 34 13 23 23 19 80 60 80 60 80 80 8 67 35 45 23 23 23 67 19 80 8 43 34 67 19 8 23 23 23 23 23 23 23 23 23 23 23 23 23 23 23 23 23 23 23 23 23 23 23 23 23 23 23 23 23 23 23 5 35 55 81 81 81 81 81 81 81 81 81 81 81 81 
81 81 81 81 81 81 81 81 81 81 81 81 81 81 81 81 81 81 81 81 81 61 81 81 81 54 34 34 23 23 23 19 80 80 80 80 80 60 8 67 35 45 23 23 23 67 19 80 8 43 34 67 19 8 23 23 23 23 23 23 23 23 23 23 23 23 23 23 23 23 23 23 23 23 23 23 23 23 23 23 23 23 23 23 23 35 35 55 81 81 81 81 81 81 81 81 81 81 81 81 
81 81 81 81 81 81 81 81 81 81 81 81 81 61 81 81 81 61 81 81 81 81 81 81 81 54 34 34 23 13 23 19 80 60 80 80 80 80 8 67 35 45 23 23 23 67 19 80 8 44 34 67 19 8 23 23 23 23 23 23 23 23 23 23 23 23 23 23 23 23 23 23 23 23 23 23 23 23 23 23 23 23 23 23 23 35 35 55 81 81 81 81 81 81 81 81 81 81 61 81 
81 81 81 61 81 81 81 81 81 81 81 81 81 81 81 81 81 81 81 81 81 81 81 81 81 14 4 23 23 23 23 95 9 9 9 9 9 9 96 67 35 45 23 23 23 77 19 80 8 44 34 67 19 8 23 23 23 23 23 23 23 23 23 23 23 23 23 23 23 23 23 23 23 23 23 23 23 23 23 23 23 23 23 23 23 35 35 55 81 81 81 61 81 81 81 81 81 81 81 81 
81 81 81 81 81 81 81 81 81 81 14 3 3 3 3 3 3 3 3 3 3 3 3 3 3 4 13 23 23 23 67 67 67 67 67 67 67 67 67 23 35 45 23 23 23 67 19 80 8 44 34 67 95 96 23 23 23 23 23 23 23 23 23 23 23 23 23 23 23 23 23 23 23 23 23 23 23 23 23 23 23 23 23 23 23 35 35 55 81 81 81 81 81 81 81 81 81 81 81 81 
81 81 81 81 81 81 81 81 81 54 34 4 3 3 3 3 3 3 3 3 3 3 3 3 3 43 23 13 1 1 1 1 1 1 1 1 1 1 1 1 2 45 23 23 23 67 19 80 8 44 0 1 53 53 1 1 1 43 23 43 23 23 23 23 23 23 23 23 23 23 23 23 23 23 23 23 23 23 23 23 23 23 23 23 23 35 35 55 81 81 81 81 81 81 81 81 81 81 81 81 
81 81 81 81 81 81 61 81 81 54 34 34 23 23 23 23 23 23 33 23 23 23 23 23 13 23 23 2 21 21 21 21 21 21 21 21 21 21 21 21 22 67 67 67 67 67 19 80 8 23 20 21 63 63 21 21 21 0 23 23 23 23 23 23 23 23 23 23 23 23 23 23 23 23 23 23 23 23 23 23 23 23 23 23 23 35 35 55 81 81 81 81 81 81 81 81 81 81 81 81 
81 81 81 81 81 81 81 81 81 54 34 34 77 33 23 23 23 23 23 23 23 23 23 23 23 23 35 22 85 18 18 18 18 18 18 18 18 18 18 18 18 18 18 18 18 18 17 80 16 18 18 86 74 74 85 18 86 20 43 23 23 23 23 23 23 23 23 23 23 23 23 23 23 23 23 23 23 23 23 23 23 23 23 23 23 35 35 55 81 81 81 81 81 81 81 81 81 81 81 81 
81 81 81 81 81 81 81 81 81 54 34 0 1 1 1 1 67 23 23 33 23 23 77 23 33 23 35 67 19 80 80 80 80 80 80 80 80 80 80 80 80 80 80 80 80 80 80 80 80 80 80 16 18 18 17 80 16 86 34 23 23 23 23 23 23 23 23 23 23 23 23 23 23 23 23 23 23 23 23 23 23 23 23 23 23 35 35 55 81 81 81 81 81 61 81 81 81 81 61 81 
81 81 81 81 81 81 81 81 81 54 34 20 21 21 21 21 0 67 23 23 23 33 23 23 23 23 35 67 19 80 6 9 9 9 9 9 9 9 9 9 9 9 9 9 9 9 7 80 6 9 9 9 9 9 9 9 7 8 34 23 23 23 43 23 23 23 23 23 23 23 23 23 23 23 23 23 23 23 23 23 23 23 23 23 23 35 35 55 81 81 81 81 81 81 81 81 81 81 81 81 
81 81 81 81 81 81 81 81 81 54 34 67 85 18 18 86 20 0 67 23 23 23 23 33 23 23 35 67 19 80 8 13 67 67 67 67 67 67 67 67 67 67 67 67 67 67 95 7 8 23 23 23 23 23 23 23 19 8 34 23 23 23 23 23 43 23 23 23 23 23 23 23 23 23 23 23 23 23 23 23 23 23 23 23 23 35 35 55 81 81 81 61 81 81 81 81 81 81 81 81 
81 81 61 81 81 81 81 81 81 54 34 85 17 60 60 16 86 20 0 67 23 23 23 23 23 33 35 67 19 80 8 67 23 23 23 23 23 23 23 23 23 23 77 23 23 43 43 95 96 23 23 23 23 23 23 23 19 8 34 23 23 23 23 23 23 23 23 23 23 23 23 23 23 23 23 23 23 23 23 23 23 23 23 23 23 35 35 55 81 81 81 81 81 81 81 81 81 81 81 81 
81 81 81 81 81 81 81 81 81 54 34 19 60 80 80 80 16 86 20 34 67 67 67 67 23 23 35 67 19 80 8 67 23 13 23 23 23 23 23 13 23 23 67 1 1 1 1 53 53 1 1 1 1 1 23 23 19 8 34 23 23 23 23 23 23 23 23 23 23 23 23 23 23 23 23 23 23 23 23 23 23 23 23 23 23 35 35 55 81 81 81 81 81 81 81 81 81 81 81 81 
81 81 81 81 81 81 81 81 81 54 34 19 80 80 80 80 80 8 67 0 1 1 1 1 53 53 2 67 19 80 8 67 23 23 13 23 13 23 23 23 23 67 2 41 41 41 41 63 63 41 41 41 41 41 0 43 19 8 34 23 23 23 23 23 23 23 23 23 23 23 23 23 23 23 23 23 23 23 23 23 23 23 23 23 23 2 35 55 61 81 81 81 81 81 81 81 81 81 81 81 
81 81 81 81 81 81 61 81 81 54 34 19 80 80 80 80 80 8 67 20 21 21 21 21 63 63 22 67 19 80 8 33 67 23 23 23 23 23 23 23 67 35 42 72 72 72 72 75 75 72 72 72 72 72 40 34 19 8 0 23 23 23 23 23 23 23 23 23 23 23 23 23 23 23 23 23 23 23 23 23 23 23 23 23 2 22 35 55 81 81 81 81 61 81 81 81 81 81 81 81 
81 81 81 81 81 81 81 81 81 54 34 19 80 80 80 80 80 16 18 18 18 18 18 86 74 74 85 18 17 80 8 67 23 23 23 13 23 13 23 23 67 35 65 72 72 72 72 72 72 72 72 72 72 72 72 34 95 96 20 21 21 21 21 21 21 21 21 21 21 21 21 21 21 21 21 21 21 21 21 21 21 21 21 21 22 23 35 55 81 81 81 81 81 81 81 81 81 61 81 81 
81 81 81 81 81 81 81 81 81 54 34 19 80 80 80 80 80 80 80 80 80 80 80 16 18 18 17 80 80 80 8 67 23 13 23 23 13 23 23 23 67 35 65 72 72 72 72 72 72 72 72 72 72 72 72 0 1 1 1 1 1 1 1 1 1 1 1 1 1 1 1 1 1 1 1 1 1 1 1 1 1 1 1 1 1 1 2 55 81 81 81 81 81 81 81 81 81 81 81 81 
81 81 81 81 81 81 81 81 81 54 34 19 80 80 80 80 80 6 9 9 9 9 9 9 9 9 9 9 9 9 96 67 23 23 23 23 23 13 13 23 67 35 65 64 62 72 72 78 72 72 72 72 72 69 58 50 31 31 31 31 31 31 31 31 31 31 31 31 31 31 31 31 31 31 31 31 31 31 31 31 31 31 31 31 31 31 32 81 81 81 81 81 81 81 81 81 81 81 81 81 
81 81 81 81 81 81 81 81 81 54 34 19 80 80 80 80 6 96 67 67 67 67 67 67 67 67 67 67 67 67 67 23 23 13 23 23 23 23 23 23 67 35 65 64 72 72 72 72 72 72 72 78 69 57 81 81 81 81 81 81 81 81 81 81 81 81 81 81 81 81 81 81 81 81 81 81 81 81 81 81 81 81 81 81 81 81 81 81 81 81 81 81 81 81 81 81 81 81 81 81 
81 81 81 81 61 81 81 81 81 54 34 19 80 80 80 6 96 67 77 43 33 33 43 33 13 43 33 13 13 33 43 67 23 23 23 23 23 23 23 23 67 35 65 64 72 72 72 72 72 72 72 69 57 81 81 81 81 81 81 81 61 81 81 81 81 61 81 81 81 81 81 81 81 81 81 81 81 81 81 81 81 81 81 81 81 61 81 81 81 81 81 61 81 81 81 81 81 81 81 81 
81 81 81 81 81 81 81 81 81 54 34 95 9 9 9 96 67 77 13 33 43 13 13 13 33 13 43 13 33 13 13 33 67 67 67 67 67 67 67 67 67 35 65 78 64 64 64 64 64 64 69 57 81 81 81 81 81 81 81 81 81 81 81 81 81 81 81 81 81 81 81 81 61 81 81 81 81 81 81 81 81 81 81 81 81 81 81 81 81 81 81 81 81 81 81 81 81 81 81 81 
81 81 81 81 81 81 81 81 81 54 0 1 1 1 1 1 1 1 1 1 1 1 1 1 1 1 1 1 1 1 1 1 1 1 1 1 1 1 1 1 1 2 65 64 64 64 62 64 64 69 57 81 81 81 81 81 81 61 81 81 61 81 81 81 81 81 81 81 81 81 81 81 81 81 81 61 81 81 81 81 81 61 81 81 81 81 81 81 81 81 81 81 81 81 81 81 81 81 81 81 
81 81 81 81 81 81 61 81 81 81 30 31 31 31 31 31 31 31 31 31 31 31 31 31 31 31 31 31 31 31 31 31 31 31 31 31 31 31 31 31 31 52 58 58 58 58 58 58 58 57 81 81 81 81 81 81 81 81 81 81 81 81 81 81 81 61 81 81 81 81 81 81 81 81 81 81 81 81 81 81 81 81 81 81 81 81 81 81 81 81 81 81 81 81 61 81 81 81 81 81 
81 81 81 81 81 81 81 81 81 81 81 81 81 81 81 81 81 81 81 81 81 81 81 81 81 81 81 81 81 81 81 81 81 81 81 81 81 81 81 81 81 81 81 81 81 81 81 81 81 81 81 81 81 81 61 81 61 81 81 81 81 81 81 81 81 81 81 81 81 81 81 81 81 81 81 81 81 81 81 81 81 81 81 81 81 61 81 81 81 81 81 81 81 81 81 81 81 81 81 81 
81 81 81 81 81 81 81 81 81 81 81 81 81 81 81 81 81 81 81 81 81 81 81 81 81 81 81 81 81 81 81 81 81 81 81 81 81 81 81 81 81 81 81 81 81 81 81 81 81 81 81 81 61 81 81 81 81 81 81 81 81 81 61 81 81 81 81 81 81 81 61 81 81 81 81 81 81 81 61 81 81 81 81 81 81 81 81 81 81 81 81 81 81 81 81 81 81 81 81 81 
81 81 81 81 61 81 81 81 81 81 61 81 81 81 81 81 81 81 81 81 81 61 81 81 81 81 81 81 81 81 81 61 81 81 61 81 81 81 81 81 81 81 81 81 81 81 61 81 81 81 81 61 81 81 81 81 81 81 81 81 81 81 81 81 81 81 81 81 81 81 81 81 81 81 81 81 81 81 81 81 81 81 81 81 81 81 81 81 81 81 61 81 81 81 81 81 81 61 81 81 
81 81 81 81 81 81 81 81 81 81 81 81 81 81 81 81 81 81 81 81 81 81 81 81 81 81 81 81 81 81 81 81 81 81 81 81 81 81 81 81 81 81 81 81 81 81 81 81 81 81 81 81 81 81 81 81 61 81 81 81 81 81 81 81 81 81 81 81 81 81 81 81 81 81 81 81 81 81 81 81 81 81 81 81 81 81 81 81 81 81 81 81 81 81 81 81 81 81 81 81 
81 81 81 81 81 81 81 81 81 81 81 81 81 81 61 81 81 81 81 81 81 81 81 81 81 81 61 81 81 81 81 81 81 81 81 81 81 61 81 81 81 81 81 81 81 81 81 61 81 81 81 81 81 81 81 81 81 81 81 81 81 81 81 81 81 61 81 81 81 81 81 81 81 81 81 81 81 81 81 81 81 81 81 81 81 81 81 81 81 81 81 81 81 81 81 81 81 81 81 81 
81 81 81 81 81 81 81 61 81 81 81 81 81 81 81 81 81 81 81 81 81 81 81 81 81 81 81 81 81 81 81 81 81 81 81 81 81 81 81 81 81 81 81 81 81 81 81 81 81 81 81 61 81 81 81 81 81 81 81 81 81 81 81 81 81 81 81 81 81 81 81 81 81 81 61 81 81 81 81 61 81 81 81 81 81 81 81 81 81 81 81 81 81 81 81 61 81 81 81 81 
81 81 81 61 81 81 81 81 81 81 81 81 81 81 81 81 81 81 81 81 81 81 81 81 81 81 81 81 81 81 81 81 81 81 81 81 81 81 61 81 81 81 81 61 81 81 81 81 81 81 81 81 81 81 81 81 81 81 81 81 81 81 81 81 81 81 81 81 81 81 81 81 81 81 81 81 81 81 81 81 81 81 81 81 81 81 81 81 81 81 81 81 81 81 81 81 81 81 81 81 
81 81 81 81 81 81 81 81 81 81 81 81 81 81 81 81 81 81 61 81 81 81 81 81 81 81 81 81 81 81 81 81 81 81 81 81 81 81 81 81 81 81 81 81 81 81 81 81 81 81 81 81 81 81 81 81 81 81 81 81 81 81 61 81 81 81 81 81 81 61 81 81 81 81 81 81 81 81 81 81 81 81 81 81 81 81 81 81 61 81 81 81 81 81 81 81 81 81 81 81 
81 81 81 81 81 81 81 81 81 81 81 81 81 81 81 81 81 81 81 81 81 81 81 61 81 81 81 81 81 81 81 81 81 81 81 81 81 81 81 81 81 81 81 81 81 81 81 81 81 81 81 81 81 81 81 81 81 81 81 81 81 81 81 81 81 81 81 81 81 81 81 81 81 81 81 81 81 81 81 81 81 81 81 81 81 81 81 81 81 81 81 81 81 81 81 81 81 81 81 81 
81 81 81 81 81 81 81 81 81 81 81 81 81 81 81 81 81 81 81 81 81 81 81 81 81 81 81 81 81 81 81 81 81 81 61 81 81 81 81 81 81 81 81 81 81 81 81 81 81 81 81 81 81 81 81 81 81 81 81 81 81 81 81 81 81 81 81 81 81 81 81 81 81 81 81 81 81 81 81 81 81 81 81 81 81 81 81 81 81 81 81 81 81 81 81 81 81 81 81 81 
